00,00,00,08,00,00,00,08,00,00,00
00,00,00,00,08,00,08,00,00,00,00
00,00,00,00,08,00,08,00,00,00,00
00,00,00,09,09,09,09,09,00,00,00
00,00,00,09,09,09,09,09,00,00,00
00,00,09,09,05,09,05,09,09,00,00
00,00,09,09,05,09,05,09,09,00,00
00,09,09,09,09,09,09,09,09,09,00
00,09,09,09,09,09,09,09,09,09,00
