09,09,09,09,09,09,09,09,09,09,09
05,05,05,05,05,05,05,05,05,05,05
06,06,06,06,06,06,06,06,06,06,06
08,08,08,08,08,08,08,08,08,08,08
07,07,07,07,07,07,07,07,07,07,07
04,04,04,04,04,04,04,04,04,04,04