02,00,00,00,00,00,00,00,00,00,00
02,03,00,00,00,00,00,00,00,00,00
02,03,04,00,00,00,00,00,00,00,00
02,03,04,06,00,00,00,00,00,00,00
02,03,04,06,05,00,00,00,00,00,00
02,03,04,06,05,02,00,00,00,00,00
02,03,04,06,05,02,03,00,00,00,00
02,03,04,06,05,02,03,04,00,00,00
02,03,04,06,05,02,03,04,06,00,00
02,03,04,06,05,02,03,04,06,05,00
10,10,10,10,10,10,10,10,10,10,02
