04,04,04,04,04,04,04,04,04,04,04
01,01,01,10,10,10,10,10,10,10,10
05,05,05,05,05,05,05,05,05,05,05
10,10,10,10,10,10,10,10,01,01,01
07,07,07,07,07,07,07,07,07,07,07
06,06,06,10,10,10,10,10,10,10,10
06,06,06,06,06,06,06,06,06,06,06
05,05,05,05,05,05,05,05,05,05,05
