00,09,08,04,07,00,08,04,06,09,00
00,06,04,08,05,00,04,08,09,06,00
00,04,07,05,08,00,06,09,08,04,00
00,08,05,07,04,00,09,06,04,08,00
00,05,08,04,06,00,08,04,07,05,00
00,07,04,08,09,00,04,08,05,07,00
00,04,06,09,08,00,07,05,08,04,00
00,08,09,06,04,00,05,07,04,08,00
00,09,08,04,07,00,08,04,06,09,00
00,06,04,08,05,00,04,08,09,06,00
00,04,07,05,08,00,06,09,08,04,00
00,08,05,07,04,00,09,06,04,08,00
00,05,08,04,06,00,08,04,07,05,00
00,07,04,08,09,00,04,08,05,07,00